geoid,NAME,B25002_001E,B25002_002E,B25002_003E,state,county,tract,block group,table
360670112322,"Block Group 2, Census Tract 112.32, Onondaga County, New York",594,594,0,36,067,011232,2,b25002
360670115001,"Block Group 1, Census Tract 115, Onondaga County, New York",805,762,43,36,067,011500,1,b25002
360670115003,"Block Group 3, Census Tract 115, Onondaga County, New York",586,561,25,36,067,011500,3,b25002
360670115002,"Block Group 2, Census Tract 115, Onondaga County, New York",967,856,111,36,067,011500,2,b25002
360670002002,"Block Group 2, Census Tract 2, Onondaga County, New York",821,568,253,36,067,000200,2,b25002
360670002001,"Block Group 1, Census Tract 2, Onondaga County, New York",892,785,107,36,067,000200,1,b25002
360670046001,"Block Group 1, Census Tract 46, Onondaga County, New York",409,271,138,36,067,004600,1,b25002
360670046002,"Block Group 2, Census Tract 46, Onondaga County, New York",518,518,0,36,067,004600,2,b25002
360670046003,"Block Group 3, Census Tract 46, Onondaga County, New York",610,503,107,36,067,004600,3,b25002
360670046005,"Block Group 5, Census Tract 46, Onondaga County, New York",284,202,82,36,067,004600,5,b25002
360670103212,"Block Group 2, Census Tract 103.21, Onondaga County, New York",563,541,22,36,067,010321,2,b25002
360670103211,"Block Group 1, Census Tract 103.21, Onondaga County, New York",448,433,15,36,067,010321,1,b25002
360670119004,"Block Group 4, Census Tract 119, Onondaga County, New York",261,234,27,36,067,011900,4,b25002
360670119001,"Block Group 1, Census Tract 119, Onondaga County, New York",395,387,8,36,067,011900,1,b25002
360670119003,"Block Group 3, Census Tract 119, Onondaga County, New York",367,292,75,36,067,011900,3,b25002
360670126001,"Block Group 1, Census Tract 126, Onondaga County, New York",275,275,0,36,067,012600,1,b25002
360670126003,"Block Group 3, Census Tract 126, Onondaga County, New York",640,563,77,36,067,012600,3,b25002
360670134003,"Block Group 3, Census Tract 134, Onondaga County, New York",512,512,0,36,067,013400,3,b25002
360670134001,"Block Group 1, Census Tract 134, Onondaga County, New York",535,535,0,36,067,013400,1,b25002
360670138002,"Block Group 2, Census Tract 138, Onondaga County, New York",395,366,29,36,067,013800,2,b25002
360670166003,"Block Group 3, Census Tract 166, Onondaga County, New York",1067,955,112,36,067,016600,3,b25002
360670166002,"Block Group 2, Census Tract 166, Onondaga County, New York",607,563,44,36,067,016600,2,b25002
360670124002,"Block Group 2, Census Tract 124, Onondaga County, New York",328,328,0,36,067,012400,2,b25002
360670124001,"Block Group 1, Census Tract 124, Onondaga County, New York",654,577,77,36,067,012400,1,b25002
360670024002,"Block Group 2, Census Tract 24, Onondaga County, New York",430,360,70,36,067,002400,2,b25002
360670034001,"Block Group 1, Census Tract 34, Onondaga County, New York",977,672,305,36,067,003400,1,b25002
360670048002,"Block Group 2, Census Tract 48, Onondaga County, New York",415,387,28,36,067,004800,2,b25002
360670053002,"Block Group 2, Census Tract 53, Onondaga County, New York",427,331,96,36,067,005300,2,b25002
360670055001,"Block Group 1, Census Tract 55, Onondaga County, New York",389,320,69,36,067,005500,1,b25002
360670055002,"Block Group 2, Census Tract 55, Onondaga County, New York",940,881,59,36,067,005500,2,b25002
360670056011,"Block Group 1, Census Tract 56.01, Onondaga County, New York",779,694,85,36,067,005601,1,b25002
360670143003,"Block Group 3, Census Tract 143, Onondaga County, New York",519,416,103,36,067,014300,3,b25002
360670143002,"Block Group 2, Census Tract 143, Onondaga County, New York",426,401,25,36,067,014300,2,b25002
360670147001,"Block Group 1, Census Tract 147, Onondaga County, New York",384,340,44,36,067,014700,1,b25002
360670147004,"Block Group 4, Census Tract 147, Onondaga County, New York",605,563,42,36,067,014700,4,b25002
360670147003,"Block Group 3, Census Tract 147, Onondaga County, New York",397,381,16,36,067,014700,3,b25002
360670152021,"Block Group 1, Census Tract 152.02, Onondaga County, New York",827,793,34,36,067,015202,1,b25002
360670152022,"Block Group 2, Census Tract 152.02, Onondaga County, New York",930,873,57,36,067,015202,2,b25002
360670003002,"Block Group 2, Census Tract 3, Onondaga County, New York",383,311,72,36,067,000300,2,b25002
360670006002,"Block Group 2, Census Tract 6, Onondaga County, New York",523,404,119,36,067,000600,2,b25002
360670124004,"Block Group 4, Census Tract 124, Onondaga County, New York",397,397,0,36,067,012400,4,b25002
360670111023,"Block Group 3, Census Tract 111.02, Onondaga County, New York",614,427,187,36,067,011102,3,b25002
360670112014,"Block Group 4, Census Tract 112.01, Onondaga County, New York",496,449,47,36,067,011201,4,b25002
360670144001,"Block Group 1, Census Tract 144, Onondaga County, New York",330,330,0,36,067,014400,1,b25002
360670006003,"Block Group 3, Census Tract 6, Onondaga County, New York",472,313,159,36,067,000600,3,b25002
360670017011,"Block Group 1, Census Tract 17.01, Onondaga County, New York",634,510,124,36,067,001701,1,b25002
360670018003,"Block Group 3, Census Tract 18, Onondaga County, New York",820,820,0,36,067,001800,3,b25002
360670061022,"Block Group 2, Census Tract 61.02, Onondaga County, New York",800,588,212,36,067,006102,2,b25002
360670112012,"Block Group 2, Census Tract 112.01, Onondaga County, New York",364,332,32,36,067,011201,2,b25002
360670112011,"Block Group 1, Census Tract 112.01, Onondaga County, New York",230,230,0,36,067,011201,1,b25002
360670167001,"Block Group 1, Census Tract 167, Onondaga County, New York",814,550,264,36,067,016700,1,b25002
360670167002,"Block Group 2, Census Tract 167, Onondaga County, New York",677,494,183,36,067,016700,2,b25002
360670169011,"Block Group 1, Census Tract 169.01, Onondaga County, New York",566,546,20,36,067,016901,1,b25002
360670169012,"Block Group 2, Census Tract 169.01, Onondaga County, New York",678,549,129,36,067,016901,2,b25002
360670008002,"Block Group 2, Census Tract 8, Onondaga County, New York",606,451,155,36,067,000800,2,b25002
360670008001,"Block Group 1, Census Tract 8, Onondaga County, New York",608,549,59,36,067,000800,1,b25002
360670112411,"Block Group 1, Census Tract 112.41, Onondaga County, New York",393,365,28,36,067,011241,1,b25002
360670112421,"Block Group 1, Census Tract 112.42, Onondaga County, New York",231,231,0,36,067,011242,1,b25002
360670112423,"Block Group 3, Census Tract 112.42, Onondaga County, New York",632,632,0,36,067,011242,3,b25002
360670125001,"Block Group 1, Census Tract 125, Onondaga County, New York",405,364,41,36,067,012500,1,b25002
360670125003,"Block Group 3, Census Tract 125, Onondaga County, New York",593,497,96,36,067,012500,3,b25002
360670151005,"Block Group 5, Census Tract 151, Onondaga County, New York",926,793,133,36,067,015100,5,b25002
360670151003,"Block Group 3, Census Tract 151, Onondaga County, New York",503,491,12,36,067,015100,3,b25002
360670131001,"Block Group 1, Census Tract 131, Onondaga County, New York",373,330,43,36,067,013100,1,b25002
360670131003,"Block Group 3, Census Tract 131, Onondaga County, New York",475,452,23,36,067,013100,3,b25002
360670139002,"Block Group 2, Census Tract 139, Onondaga County, New York",471,443,28,36,067,013900,2,b25002
360670154001,"Block Group 1, Census Tract 154, Onondaga County, New York",692,588,104,36,067,015400,1,b25002
360670154002,"Block Group 2, Census Tract 154, Onondaga County, New York",742,701,41,36,067,015400,2,b25002
360670165024,"Block Group 4, Census Tract 165.02, Onondaga County, New York",426,426,0,36,067,016502,4,b25002
360670165022,"Block Group 2, Census Tract 165.02, Onondaga County, New York",622,589,33,36,067,016502,2,b25002
360670015001,"Block Group 1, Census Tract 15, Onondaga County, New York",692,502,190,36,067,001500,1,b25002
360670146001,"Block Group 1, Census Tract 146, Onondaga County, New York",892,721,171,36,067,014600,1,b25002
360670146004,"Block Group 4, Census Tract 146, Onondaga County, New York",336,336,0,36,067,014600,4,b25002
360670146002,"Block Group 2, Census Tract 146, Onondaga County, New York",337,313,24,36,067,014600,2,b25002
360670043023,"Block Group 3, Census Tract 43.02, Onondaga County, New York",536,395,141,36,067,004302,3,b25002
360670043022,"Block Group 2, Census Tract 43.02, Onondaga County, New York",85,57,28,36,067,004302,2,b25002
360670021011,"Block Group 1, Census Tract 21.01, Onondaga County, New York",285,183,102,36,067,002101,1,b25002
360670021012,"Block Group 2, Census Tract 21.01, Onondaga County, New York",540,410,130,36,067,002101,2,b25002
360670137013,"Block Group 3, Census Tract 137.01, Onondaga County, New York",484,457,27,36,067,013701,3,b25002
360670137014,"Block Group 4, Census Tract 137.01, Onondaga County, New York",409,409,0,36,067,013701,4,b25002
360670005011,"Block Group 1, Census Tract 5.01, Onondaga County, New York",580,433,147,36,067,000501,1,b25002
360670005012,"Block Group 2, Census Tract 5.01, Onondaga County, New York",589,455,134,36,067,000501,2,b25002
360670029012,"Block Group 2, Census Tract 29.01, Onondaga County, New York",637,536,101,36,067,002901,2,b25002
360670156011,"Block Group 1, Census Tract 156.01, Onondaga County, New York",593,567,26,36,067,015601,1,b25002
360670156013,"Block Group 3, Census Tract 156.01, Onondaga County, New York",439,386,53,36,067,015601,3,b25002
360670151004,"Block Group 4, Census Tract 151, Onondaga County, New York",482,442,40,36,067,015100,4,b25002
360670151001,"Block Group 1, Census Tract 151, Onondaga County, New York",525,525,0,36,067,015100,1,b25002
360670169022,"Block Group 2, Census Tract 169.02, Onondaga County, New York",346,273,73,36,067,016902,2,b25002
360670169021,"Block Group 1, Census Tract 169.02, Onondaga County, New York",558,533,25,36,067,016902,1,b25002
360670152032,"Block Group 2, Census Tract 152.03, Onondaga County, New York",831,790,41,36,067,015203,2,b25002
360670152031,"Block Group 1, Census Tract 152.03, Onondaga County, New York",324,324,0,36,067,015203,1,b25002
360670142001,"Block Group 1, Census Tract 142, Onondaga County, New York",394,394,0,36,067,014200,1,b25002
360670142002,"Block Group 2, Census Tract 142, Onondaga County, New York",684,605,79,36,067,014200,2,b25002
360670144002,"Block Group 2, Census Tract 144, Onondaga County, New York",386,231,155,36,067,014400,2,b25002
360670145002,"Block Group 2, Census Tract 145, Onondaga County, New York",819,763,56,36,067,014500,2,b25002
360670146003,"Block Group 3, Census Tract 146, Onondaga County, New York",305,282,23,36,067,014600,3,b25002
360670155002,"Block Group 2, Census Tract 155, Onondaga County, New York",702,680,22,36,067,015500,2,b25002
360670155001,"Block Group 1, Census Tract 155, Onondaga County, New York",534,534,0,36,067,015500,1,b25002
360670158002,"Block Group 2, Census Tract 158, Onondaga County, New York",316,316,0,36,067,015800,2,b25002
360670158003,"Block Group 3, Census Tract 158, Onondaga County, New York",458,458,0,36,067,015800,3,b25002
360670158001,"Block Group 1, Census Tract 158, Onondaga County, New York",837,837,0,36,067,015800,1,b25002
360670160011,"Block Group 1, Census Tract 160.01, Onondaga County, New York",584,584,0,36,067,016001,1,b25002
360670160012,"Block Group 2, Census Tract 160.01, Onondaga County, New York",365,365,0,36,067,016001,2,b25002
360670161001,"Block Group 1, Census Tract 161, Onondaga County, New York",919,792,127,36,067,016100,1,b25002
360670164002,"Block Group 2, Census Tract 164, Onondaga County, New York",489,468,21,36,067,016400,2,b25002
360670164001,"Block Group 1, Census Tract 164, Onondaga County, New York",518,518,0,36,067,016400,1,b25002
360670164003,"Block Group 3, Census Tract 164, Onondaga County, New York",872,727,145,36,067,016400,3,b25002
360670009001,"Block Group 1, Census Tract 9, Onondaga County, New York",444,368,76,36,067,000900,1,b25002
360670009002,"Block Group 2, Census Tract 9, Onondaga County, New York",442,415,27,36,067,000900,2,b25002
360670020002,"Block Group 2, Census Tract 20, Onondaga County, New York",668,567,101,36,067,002000,2,b25002
360670020001,"Block Group 1, Census Tract 20, Onondaga County, New York",445,352,93,36,067,002000,1,b25002
360670030002,"Block Group 2, Census Tract 30, Onondaga County, New York",451,375,76,36,067,003000,2,b25002
360670044002,"Block Group 2, Census Tract 44, Onondaga County, New York",573,425,148,36,067,004400,2,b25002
360670044001,"Block Group 1, Census Tract 44, Onondaga County, New York",240,165,75,36,067,004400,1,b25002
360670004002,"Block Group 2, Census Tract 4, Onondaga County, New York",452,452,0,36,067,000400,2,b25002
360670007001,"Block Group 1, Census Tract 7, Onondaga County, New York",380,285,95,36,067,000700,1,b25002
360670007002,"Block Group 2, Census Tract 7, Onondaga County, New York",363,320,43,36,067,000700,2,b25002
360670010004,"Block Group 4, Census Tract 10, Onondaga County, New York",542,438,104,36,067,001000,4,b25002
360670010002,"Block Group 2, Census Tract 10, Onondaga County, New York",698,589,109,36,067,001000,2,b25002
360670152012,"Block Group 2, Census Tract 152.01, Onondaga County, New York",734,654,80,36,067,015201,2,b25002
360670152011,"Block Group 1, Census Tract 152.01, Onondaga County, New York",676,660,16,36,067,015201,1,b25002
360670107001,"Block Group 1, Census Tract 107, Onondaga County, New York",372,329,43,36,067,010700,1,b25002
360670107002,"Block Group 2, Census Tract 107, Onondaga County, New York",614,582,32,36,067,010700,2,b25002
360670120002,"Block Group 2, Census Tract 120, Onondaga County, New York",743,687,56,36,067,012000,2,b25002
360670120004,"Block Group 4, Census Tract 120, Onondaga County, New York",753,642,111,36,067,012000,4,b25002
360670120003,"Block Group 3, Census Tract 120, Onondaga County, New York",429,391,38,36,067,012000,3,b25002
360670132002,"Block Group 2, Census Tract 132, Onondaga County, New York",631,612,19,36,067,013200,2,b25002
360670151002,"Block Group 2, Census Tract 151, Onondaga County, New York",302,258,44,36,067,015100,2,b25002
360670056021,"Block Group 1, Census Tract 56.02, Onondaga County, New York",165,63,102,36,067,005602,1,b25002
360670168012,"Block Group 2, Census Tract 168.01, Onondaga County, New York",801,423,378,36,067,016801,2,b25002
360670014002,"Block Group 2, Census Tract 14, Onondaga County, New York",594,450,144,36,067,001400,2,b25002
360670139001,"Block Group 1, Census Tract 139, Onondaga County, New York",692,653,39,36,067,013900,1,b25002
360670052002,"Block Group 2, Census Tract 52, Onondaga County, New York",395,259,136,36,067,005200,2,b25002
360670052003,"Block Group 3, Census Tract 52, Onondaga County, New York",303,261,42,36,067,005200,3,b25002
360670061032,"Block Group 2, Census Tract 61.03, Onondaga County, New York",369,311,58,36,067,006103,2,b25002
360670061031,"Block Group 1, Census Tract 61.03, Onondaga County, New York",826,748,78,36,067,006103,1,b25002
360670102002,"Block Group 2, Census Tract 102, Onondaga County, New York",585,502,83,36,067,010200,2,b25002
360670102001,"Block Group 1, Census Tract 102, Onondaga County, New York",1368,1284,84,36,067,010200,1,b25002
360670103015,"Block Group 5, Census Tract 103.01, Onondaga County, New York",772,724,48,36,067,010301,5,b25002
360670027003,"Block Group 3, Census Tract 27, Onondaga County, New York",333,273,60,36,067,002700,3,b25002
360670027002,"Block Group 2, Census Tract 27, Onondaga County, New York",365,328,37,36,067,002700,2,b25002
360670036012,"Block Group 2, Census Tract 36.01, Onondaga County, New York",563,451,112,36,067,003601,2,b25002
360670110211,"Block Group 1, Census Tract 110.21, Onondaga County, New York",652,590,62,36,067,011021,1,b25002
360670054002,"Block Group 2, Census Tract 54, Onondaga County, New York",314,215,99,36,067,005400,2,b25002
360670054003,"Block Group 3, Census Tract 54, Onondaga County, New York",235,187,48,36,067,005400,3,b25002
360670060004,"Block Group 4, Census Tract 60, Onondaga County, New York",540,468,72,36,067,006000,4,b25002
360670060003,"Block Group 3, Census Tract 60, Onondaga County, New York",639,593,46,36,067,006000,3,b25002
360670060002,"Block Group 2, Census Tract 60, Onondaga County, New York",348,323,25,36,067,006000,2,b25002
360670106001,"Block Group 1, Census Tract 106, Onondaga County, New York",484,436,48,36,067,010600,1,b25002
360670111012,"Block Group 2, Census Tract 111.01, Onondaga County, New York",432,432,0,36,067,011101,2,b25002
360670111014,"Block Group 4, Census Tract 111.01, Onondaga County, New York",169,169,0,36,067,011101,4,b25002
360670111013,"Block Group 3, Census Tract 111.01, Onondaga County, New York",530,455,75,36,067,011101,3,b25002
360670111021,"Block Group 1, Census Tract 111.02, Onondaga County, New York",421,397,24,36,067,011102,1,b25002
360670111022,"Block Group 2, Census Tract 111.02, Onondaga County, New York",954,879,75,36,067,011102,2,b25002
360670130002,"Block Group 2, Census Tract 130, Onondaga County, New York",407,349,58,36,067,013000,2,b25002
360670130005,"Block Group 5, Census Tract 130, Onondaga County, New York",436,385,51,36,067,013000,5,b25002
360670130004,"Block Group 4, Census Tract 130, Onondaga County, New York",407,352,55,36,067,013000,4,b25002
360670157003,"Block Group 3, Census Tract 157, Onondaga County, New York",599,581,18,36,067,015700,3,b25002
360670157004,"Block Group 4, Census Tract 157, Onondaga County, New York",885,787,98,36,067,015700,4,b25002
360670157001,"Block Group 1, Census Tract 157, Onondaga County, New York",634,511,123,36,067,015700,1,b25002
360670128001,"Block Group 1, Census Tract 128, Onondaga County, New York",355,355,0,36,067,012800,1,b25002
360670163002,"Block Group 2, Census Tract 163, Onondaga County, New York",416,375,41,36,067,016300,2,b25002
360670163003,"Block Group 3, Census Tract 163, Onondaga County, New York",418,324,94,36,067,016300,3,b25002
360670163006,"Block Group 6, Census Tract 163, Onondaga County, New York",295,244,51,36,067,016300,6,b25002
360670163004,"Block Group 4, Census Tract 163, Onondaga County, New York",385,335,50,36,067,016300,4,b25002
360670001001,"Block Group 1, Census Tract 1, Onondaga County, New York",646,486,160,36,067,000100,1,b25002
360670051003,"Block Group 3, Census Tract 51, Onondaga County, New York",362,288,74,36,067,005100,3,b25002
360670050001,"Block Group 1, Census Tract 50, Onondaga County, New York",623,483,140,36,067,005000,1,b25002
360670050002,"Block Group 2, Census Tract 50, Onondaga County, New York",543,514,29,36,067,005000,2,b25002
360670057001,"Block Group 1, Census Tract 57, Onondaga County, New York",402,346,56,36,067,005700,1,b25002
360670057002,"Block Group 2, Census Tract 57, Onondaga County, New York",496,392,104,36,067,005700,2,b25002
360670058002,"Block Group 2, Census Tract 58, Onondaga County, New York",255,163,92,36,067,005800,2,b25002
360670058003,"Block Group 3, Census Tract 58, Onondaga County, New York",375,261,114,36,067,005800,3,b25002
360670058001,"Block Group 1, Census Tract 58, Onondaga County, New York",365,234,131,36,067,005800,1,b25002
360670108003,"Block Group 3, Census Tract 108, Onondaga County, New York",441,425,16,36,067,010800,3,b25002
360670108001,"Block Group 1, Census Tract 108, Onondaga County, New York",697,697,0,36,067,010800,1,b25002
360670108004,"Block Group 4, Census Tract 108, Onondaga County, New York",776,776,0,36,067,010800,4,b25002
360670108002,"Block Group 2, Census Tract 108, Onondaga County, New York",311,311,0,36,067,010800,2,b25002
360670133001,"Block Group 1, Census Tract 133, Onondaga County, New York",320,304,16,36,067,013300,1,b25002
360670133002,"Block Group 2, Census Tract 133, Onondaga County, New York",387,372,15,36,067,013300,2,b25002
360670133003,"Block Group 3, Census Tract 133, Onondaga County, New York",454,437,17,36,067,013300,3,b25002
360670110123,"Block Group 3, Census Tract 110.12, Onondaga County, New York",1030,993,37,36,067,011012,3,b25002
360670110121,"Block Group 1, Census Tract 110.12, Onondaga County, New York",415,401,14,36,067,011012,1,b25002
360670115004,"Block Group 4, Census Tract 115, Onondaga County, New York",201,201,0,36,067,011500,4,b25002
360670019005,"Block Group 5, Census Tract 19, Onondaga County, New York",324,302,22,36,067,001900,5,b25002
360670019004,"Block Group 4, Census Tract 19, Onondaga County, New York",505,505,0,36,067,001900,4,b25002
360670019003,"Block Group 3, Census Tract 19, Onondaga County, New York",521,479,42,36,067,001900,3,b25002
360670023002,"Block Group 2, Census Tract 23, Onondaga County, New York",757,538,219,36,067,002300,2,b25002
360670023001,"Block Group 1, Census Tract 23, Onondaga County, New York",407,256,151,36,067,002300,1,b25002
360670042002,"Block Group 2, Census Tract 42, Onondaga County, New York",473,393,80,36,067,004200,2,b25002
360670049002,"Block Group 2, Census Tract 49, Onondaga County, New York",270,227,43,36,067,004900,2,b25002
360670061013,"Block Group 3, Census Tract 61.01, Onondaga County, New York",638,564,74,36,067,006101,3,b25002
360670061011,"Block Group 1, Census Tract 61.01, Onondaga County, New York",766,583,183,36,067,006101,1,b25002
360670010003,"Block Group 3, Census Tract 10, Onondaga County, New York",656,619,37,36,067,001000,3,b25002
360670017022,"Block Group 2, Census Tract 17.02, Onondaga County, New York",826,714,112,36,067,001702,2,b25002
360670036022,"Block Group 2, Census Tract 36.02, Onondaga County, New York",430,384,46,36,067,003602,2,b25002
360670038002,"Block Group 2, Census Tract 38, Onondaga County, New York",498,427,71,36,067,003800,2,b25002
360670038001,"Block Group 1, Census Tract 38, Onondaga County, New York",496,374,122,36,067,003800,1,b25002
360670118005,"Block Group 5, Census Tract 118, Onondaga County, New York",824,771,53,36,067,011800,5,b25002
360670114023,"Block Group 3, Census Tract 114.02, Onondaga County, New York",546,522,24,36,067,011402,3,b25002
360670114021,"Block Group 1, Census Tract 114.02, Onondaga County, New York",525,465,60,36,067,011402,1,b25002
360670114022,"Block Group 2, Census Tract 114.02, Onondaga County, New York",720,720,0,36,067,011402,2,b25002
360670116003,"Block Group 3, Census Tract 116, Onondaga County, New York",734,686,48,36,067,011600,3,b25002
360670116002,"Block Group 2, Census Tract 116, Onondaga County, New York",677,625,52,36,067,011600,2,b25002
360670127001,"Block Group 1, Census Tract 127, Onondaga County, New York",282,282,0,36,067,012700,1,b25002
360670135003,"Block Group 3, Census Tract 135, Onondaga County, New York",534,534,0,36,067,013500,3,b25002
360670135002,"Block Group 2, Census Tract 135, Onondaga County, New York",912,871,41,36,067,013500,2,b25002
360670150004,"Block Group 4, Census Tract 150, Onondaga County, New York",423,415,8,36,067,015000,4,b25002
360670150001,"Block Group 1, Census Tract 150, Onondaga County, New York",384,384,0,36,067,015000,1,b25002
360670136001,"Block Group 1, Census Tract 136, Onondaga County, New York",492,453,39,36,067,013600,1,b25002
360670136003,"Block Group 3, Census Tract 136, Onondaga County, New York",800,725,75,36,067,013600,3,b25002
360670112321,"Block Group 1, Census Tract 112.32, Onondaga County, New York",1101,1025,76,36,067,011232,1,b25002
360670118002,"Block Group 2, Census Tract 118, Onondaga County, New York",610,610,0,36,067,011800,2,b25002
360670118004,"Block Group 4, Census Tract 118, Onondaga County, New York",509,509,0,36,067,011800,4,b25002
360670118003,"Block Group 3, Census Tract 118, Onondaga County, New York",550,550,0,36,067,011800,3,b25002
360670118001,"Block Group 1, Census Tract 118, Onondaga County, New York",488,446,42,36,067,011800,1,b25002
360670112022,"Block Group 2, Census Tract 112.02, Onondaga County, New York",631,631,0,36,067,011202,2,b25002
360670112021,"Block Group 1, Census Tract 112.02, Onondaga County, New York",1191,1167,24,36,067,011202,1,b25002
360670112312,"Block Group 2, Census Tract 112.31, Onondaga County, New York",791,748,43,36,067,011231,2,b25002
360670113002,"Block Group 2, Census Tract 113, Onondaga County, New York",370,334,36,36,067,011300,2,b25002
360670113003,"Block Group 3, Census Tract 113, Onondaga County, New York",987,888,99,36,067,011300,3,b25002
360670114012,"Block Group 2, Census Tract 114.01, Onondaga County, New York",1411,1306,105,36,067,011401,2,b25002
360670103013,"Block Group 3, Census Tract 103.01, Onondaga County, New York",637,637,0,36,067,010301,3,b25002
360670103012,"Block Group 2, Census Tract 103.01, Onondaga County, New York",262,262,0,36,067,010301,2,b25002
360670103011,"Block Group 1, Census Tract 103.01, Onondaga County, New York",227,227,0,36,067,010301,1,b25002
360670105001,"Block Group 1, Census Tract 105, Onondaga County, New York",464,450,14,36,067,010500,1,b25002
360670039001,"Block Group 1, Census Tract 39, Onondaga County, New York",284,162,122,36,067,003900,1,b25002
360670039003,"Block Group 3, Census Tract 39, Onondaga County, New York",946,578,368,36,067,003900,3,b25002
360670103221,"Block Group 1, Census Tract 103.22, Onondaga County, New York",842,773,69,36,067,010322,1,b25002
360670109001,"Block Group 1, Census Tract 109, Onondaga County, New York",468,427,41,36,067,010900,1,b25002
360670104002,"Block Group 2, Census Tract 104, Onondaga County, New York",923,837,86,36,067,010400,2,b25002
360670105002,"Block Group 2, Census Tract 105, Onondaga County, New York",490,448,42,36,067,010500,2,b25002
360679400001,"Block Group 1, Census Tract 9400, Onondaga County, New York",127,127,0,36,067,940000,1,b25002
360670160013,"Block Group 3, Census Tract 160.01, Onondaga County, New York",422,368,54,36,067,016001,3,b25002
360670148001,"Block Group 1, Census Tract 148, Onondaga County, New York",247,225,22,36,067,014800,1,b25002
360670148003,"Block Group 3, Census Tract 148, Onondaga County, New York",434,434,0,36,067,014800,3,b25002
360670168022,"Block Group 2, Census Tract 168.02, Onondaga County, New York",902,663,239,36,067,016802,2,b25002
360670027001,"Block Group 1, Census Tract 27, Onondaga County, New York",394,316,78,36,067,002700,1,b25002
360670036011,"Block Group 1, Census Tract 36.01, Onondaga County, New York",476,442,34,36,067,003601,1,b25002
360670054004,"Block Group 4, Census Tract 54, Onondaga County, New York",406,264,142,36,067,005400,4,b25002
360670054001,"Block Group 1, Census Tract 54, Onondaga County, New York",244,165,79,36,067,005400,1,b25002
360670060001,"Block Group 1, Census Tract 60, Onondaga County, New York",216,147,69,36,067,006000,1,b25002
360670106002,"Block Group 2, Census Tract 106, Onondaga County, New York",569,511,58,36,067,010600,2,b25002
360670111011,"Block Group 1, Census Tract 111.01, Onondaga County, New York",550,492,58,36,067,011101,1,b25002
360670111015,"Block Group 5, Census Tract 111.01, Onondaga County, New York",613,613,0,36,067,011101,5,b25002
360670138001,"Block Group 1, Census Tract 138, Onondaga County, New York",581,520,61,36,067,013800,1,b25002
360670166001,"Block Group 1, Census Tract 166, Onondaga County, New York",571,516,55,36,067,016600,1,b25002
360670124003,"Block Group 3, Census Tract 124, Onondaga County, New York",403,403,0,36,067,012400,3,b25002
360670059001,"Block Group 1, Census Tract 59, Onondaga County, New York",417,294,123,36,067,005900,1,b25002
360670101001,"Block Group 1, Census Tract 101, Onondaga County, New York",500,406,94,36,067,010100,1,b25002
360670110113,"Block Group 3, Census Tract 110.11, Onondaga County, New York",572,539,33,36,067,011011,3,b25002
360670045004,"Block Group 4, Census Tract 45, Onondaga County, New York",488,287,201,36,067,004500,4,b25002
360670045003,"Block Group 3, Census Tract 45, Onondaga County, New York",383,363,20,36,067,004500,3,b25002
360670110222,"Block Group 2, Census Tract 110.22, Onondaga County, New York",574,574,0,36,067,011022,2,b25002
360670112311,"Block Group 1, Census Tract 112.31, Onondaga County, New York",450,450,0,36,067,011231,1,b25002
360670112313,"Block Group 3, Census Tract 112.31, Onondaga County, New York",688,665,23,36,067,011231,3,b25002
360670113001,"Block Group 1, Census Tract 113, Onondaga County, New York",397,341,56,36,067,011300,1,b25002
360670114011,"Block Group 1, Census Tract 114.01, Onondaga County, New York",372,354,18,36,067,011401,1,b25002
360670112422,"Block Group 2, Census Tract 112.42, Onondaga County, New York",373,373,0,36,067,011242,2,b25002
360670125002,"Block Group 2, Census Tract 125, Onondaga County, New York",691,683,8,36,067,012500,2,b25002
360670131004,"Block Group 4, Census Tract 131, Onondaga County, New York",527,519,8,36,067,013100,4,b25002
360670131002,"Block Group 2, Census Tract 131, Onondaga County, New York",440,429,11,36,067,013100,2,b25002
360670154003,"Block Group 3, Census Tract 154, Onondaga County, New York",406,406,0,36,067,015400,3,b25002
360670165021,"Block Group 1, Census Tract 165.02, Onondaga County, New York",439,409,30,36,067,016502,1,b25002
360670165023,"Block Group 3, Census Tract 165.02, Onondaga County, New York",376,361,15,36,067,016502,3,b25002
360670015002,"Block Group 2, Census Tract 15, Onondaga County, New York",427,342,85,36,067,001500,2,b25002
360670128003,"Block Group 3, Census Tract 128, Onondaga County, New York",529,491,38,36,067,012800,3,b25002
360670120001,"Block Group 1, Census Tract 120, Onondaga County, New York",698,578,120,36,067,012000,1,b25002
360670132001,"Block Group 1, Census Tract 132, Onondaga County, New York",512,430,82,36,067,013200,1,b25002
360670165011,"Block Group 1, Census Tract 165.01, Onondaga County, New York",752,673,79,36,067,016501,1,b25002
360670009003,"Block Group 3, Census Tract 9, Onondaga County, New York",735,647,88,36,067,000900,3,b25002
360670030001,"Block Group 1, Census Tract 30, Onondaga County, New York",413,322,91,36,067,003000,1,b25002
360670032002,"Block Group 2, Census Tract 32, Onondaga County, New York",565,565,0,36,067,003200,2,b25002
360670004001,"Block Group 1, Census Tract 4, Onondaga County, New York",792,678,114,36,067,000400,1,b25002
360670004003,"Block Group 3, Census Tract 4, Onondaga County, New York",487,456,31,36,067,000400,3,b25002
360670010001,"Block Group 1, Census Tract 10, Onondaga County, New York",482,378,104,36,067,001000,1,b25002
360670014001,"Block Group 1, Census Tract 14, Onondaga County, New York",370,241,129,36,067,001400,1,b25002
360670019002,"Block Group 2, Census Tract 19, Onondaga County, New York",389,317,72,36,067,001900,2,b25002
360670019001,"Block Group 1, Census Tract 19, Onondaga County, New York",374,367,7,36,067,001900,1,b25002
360670042001,"Block Group 1, Census Tract 42, Onondaga County, New York",477,447,30,36,067,004200,1,b25002
360670049001,"Block Group 1, Census Tract 49, Onondaga County, New York",387,296,91,36,067,004900,1,b25002
360670061012,"Block Group 2, Census Tract 61.01, Onondaga County, New York",395,319,76,36,067,006101,2,b25002
360670035001,"Block Group 1, Census Tract 35, Onondaga County, New York",445,377,68,36,067,003500,1,b25002
360670123001,"Block Group 1, Census Tract 123, Onondaga County, New York",794,794,0,36,067,012300,1,b25002
360670112412,"Block Group 2, Census Tract 112.41, Onondaga County, New York",559,545,14,36,067,011241,2,b25002
360670116001,"Block Group 1, Census Tract 116, Onondaga County, New York",776,752,24,36,067,011600,1,b25002
360670127002,"Block Group 2, Census Tract 127, Onondaga County, New York",672,642,30,36,067,012700,2,b25002
360670135001,"Block Group 1, Census Tract 135, Onondaga County, New York",1091,1026,65,36,067,013500,1,b25002
360670150002,"Block Group 2, Census Tract 150, Onondaga County, New York",385,385,0,36,067,015000,2,b25002
360670136002,"Block Group 2, Census Tract 136, Onondaga County, New York",273,252,21,36,067,013600,2,b25002
360670018002,"Block Group 2, Census Tract 18, Onondaga County, New York",214,214,0,36,067,001800,2,b25002
360670048001,"Block Group 1, Census Tract 48, Onondaga County, New York",328,314,14,36,067,004800,1,b25002
360670053001,"Block Group 1, Census Tract 53, Onondaga County, New York",264,184,80,36,067,005300,1,b25002
360670055003,"Block Group 3, Census Tract 55, Onondaga County, New York",825,619,206,36,067,005500,3,b25002
360670130003,"Block Group 3, Census Tract 130, Onondaga County, New York",303,303,0,36,067,013000,3,b25002
360670130001,"Block Group 1, Census Tract 130, Onondaga County, New York",306,305,1,36,067,013000,1,b25002
360670157002,"Block Group 2, Census Tract 157, Onondaga County, New York",687,657,30,36,067,015700,2,b25002
360670128002,"Block Group 2, Census Tract 128, Onondaga County, New York",378,378,0,36,067,012800,2,b25002
360670163005,"Block Group 5, Census Tract 163, Onondaga County, New York",468,468,0,36,067,016300,5,b25002
360670163001,"Block Group 1, Census Tract 163, Onondaga County, New York",314,314,0,36,067,016300,1,b25002
360670051002,"Block Group 2, Census Tract 51, Onondaga County, New York",449,284,165,36,067,005100,2,b25002
360670017021,"Block Group 1, Census Tract 17.02, Onondaga County, New York",430,367,63,36,067,001702,1,b25002
360670036021,"Block Group 1, Census Tract 36.02, Onondaga County, New York",608,506,102,36,067,003602,1,b25002
360670039002,"Block Group 2, Census Tract 39, Onondaga County, New York",441,315,126,36,067,003900,2,b25002
360670109002,"Block Group 2, Census Tract 109, Onondaga County, New York",553,548,5,36,067,010900,2,b25002
360670148002,"Block Group 2, Census Tract 148, Onondaga County, New York",568,525,43,36,067,014800,2,b25002
360670168021,"Block Group 1, Census Tract 168.02, Onondaga County, New York",386,330,56,36,067,016802,1,b25002
360670143001,"Block Group 1, Census Tract 143, Onondaga County, New York",676,574,102,36,067,014300,1,b25002
360670147002,"Block Group 2, Census Tract 147, Onondaga County, New York",584,545,39,36,067,014700,2,b25002
360670119002,"Block Group 2, Census Tract 119, Onondaga County, New York",382,357,25,36,067,011900,2,b25002
360670149001,"Block Group 1, Census Tract 149, Onondaga County, New York",683,616,67,36,067,014900,1,b25002
360670003001,"Block Group 1, Census Tract 3, Onondaga County, New York",346,313,33,36,067,000300,1,b25002
360670006001,"Block Group 1, Census Tract 6, Onondaga County, New York",684,621,63,36,067,000600,1,b25002
360670017012,"Block Group 2, Census Tract 17.01, Onondaga County, New York",543,409,134,36,067,001701,2,b25002
360670018001,"Block Group 1, Census Tract 18, Onondaga County, New York",438,410,28,36,067,001800,1,b25002
360670061021,"Block Group 1, Census Tract 61.02, Onondaga County, New York",717,717,0,36,067,006102,1,b25002
360670112013,"Block Group 3, Census Tract 112.01, Onondaga County, New York",496,496,0,36,067,011201,3,b25002
360670110122,"Block Group 2, Census Tract 110.12, Onondaga County, New York",434,434,0,36,067,011012,2,b25002
360670024001,"Block Group 1, Census Tract 24, Onondaga County, New York",572,479,93,36,067,002400,1,b25002
360670103014,"Block Group 4, Census Tract 103.01, Onondaga County, New York",530,530,0,36,067,010301,4,b25002
360670126002,"Block Group 2, Census Tract 126, Onondaga County, New York",638,610,28,36,067,012600,2,b25002
360670168011,"Block Group 1, Census Tract 168.01, Onondaga County, New York",462,301,161,36,067,016801,1,b25002
360670014003,"Block Group 3, Census Tract 14, Onondaga County, New York",244,161,83,36,067,001400,3,b25002
360670046004,"Block Group 4, Census Tract 46, Onondaga County, New York",460,411,49,36,067,004600,4,b25002
360670052001,"Block Group 1, Census Tract 52, Onondaga County, New York",245,191,54,36,067,005200,1,b25002
360670102003,"Block Group 3, Census Tract 102, Onondaga County, New York",639,543,96,36,067,010200,3,b25002
360670043021,"Block Group 1, Census Tract 43.02, Onondaga County, New York",303,125,178,36,067,004302,1,b25002
360670021013,"Block Group 3, Census Tract 21.01, Onondaga County, New York",669,508,161,36,067,002101,3,b25002
360670137012,"Block Group 2, Census Tract 137.01, Onondaga County, New York",950,899,51,36,067,013701,2,b25002
360670137011,"Block Group 1, Census Tract 137.01, Onondaga County, New York",367,342,25,36,067,013701,1,b25002
360670029011,"Block Group 1, Census Tract 29.01, Onondaga County, New York",911,806,105,36,067,002901,1,b25002
360670156012,"Block Group 2, Census Tract 156.01, Onondaga County, New York",384,313,71,36,067,015601,2,b25002
360670150003,"Block Group 3, Census Tract 150, Onondaga County, New York",655,619,36,36,067,015000,3,b25002
360670126004,"Block Group 4, Census Tract 126, Onondaga County, New York",706,657,49,36,067,012600,4,b25002
360670134004,"Block Group 4, Census Tract 134, Onondaga County, New York",746,732,14,36,067,013400,4,b25002
360670142003,"Block Group 3, Census Tract 142, Onondaga County, New York",671,649,22,36,067,014200,3,b25002
360670144003,"Block Group 3, Census Tract 144, Onondaga County, New York",432,381,51,36,067,014400,3,b25002
360670160021,"Block Group 1, Census Tract 160.02, Onondaga County, New York",569,536,33,36,067,016002,1,b25002
360670154004,"Block Group 4, Census Tract 154, Onondaga County, New York",584,538,46,36,067,015400,4,b25002
360670163007,"Block Group 7, Census Tract 163, Onondaga County, New York",448,434,14,36,067,016300,7,b25002
360670158004,"Block Group 4, Census Tract 158, Onondaga County, New York",481,424,57,36,067,015800,4,b25002
360670145001,"Block Group 1, Census Tract 145, Onondaga County, New York",1122,995,127,36,067,014500,1,b25002
360670160022,"Block Group 2, Census Tract 160.02, Onondaga County, New York",521,512,9,36,067,016002,2,b25002
360670051001,"Block Group 1, Census Tract 51, Onondaga County, New York",349,273,76,36,067,005100,1,b25002
360670110112,"Block Group 2, Census Tract 110.11, Onondaga County, New York",646,646,0,36,067,011011,2,b25002
360670122001,"Block Group 1, Census Tract 122, Onondaga County, New York",589,528,61,36,067,012200,1,b25002
360670134002,"Block Group 2, Census Tract 134, Onondaga County, New York",683,683,0,36,067,013400,2,b25002
360670103222,"Block Group 2, Census Tract 103.22, Onondaga County, New York",568,533,35,36,067,010322,2,b25002
360670114013,"Block Group 3, Census Tract 114.01, Onondaga County, New York",579,579,0,36,067,011401,3,b25002
360670040001,"Block Group 1, Census Tract 40, Onondaga County, New York",707,464,243,36,067,004000,1,b25002
360670147005,"Block Group 5, Census Tract 147, Onondaga County, New York",601,601,0,36,067,014700,5,b25002
360670112424,"Block Group 4, Census Tract 112.42, Onondaga County, New York",1075,974,101,36,067,011242,4,b25002
360670043011,"Block Group 1, Census Tract 43.01, Onondaga County, New York",625,470,155,36,067,004301,1,b25002
360670110212,"Block Group 2, Census Tract 110.21, Onondaga County, New York",451,451,0,36,067,011021,2,b25002
360670032001,"Block Group 1, Census Tract 32, Onondaga County, New York",1126,986,140,36,067,003200,1,b25002
360670162001,"Block Group 1, Census Tract 162, Onondaga County, New York",281,267,14,36,067,016200,1,b25002
360670114014,"Block Group 4, Census Tract 114.01, Onondaga County, New York",867,867,0,36,067,011401,4,b25002
360670117001,"Block Group 1, Census Tract 117, Onondaga County, New York",668,589,79,36,067,011700,1,b25002
360670117002,"Block Group 2, Census Tract 117, Onondaga County, New York",1080,1051,29,36,067,011700,2,b25002
360670121001,"Block Group 1, Census Tract 121, Onondaga County, New York",630,580,50,36,067,012100,1,b25002
360670121002,"Block Group 2, Census Tract 121, Onondaga County, New York",527,486,41,36,067,012100,2,b25002
360670121003,"Block Group 3, Census Tract 121, Onondaga County, New York",622,586,36,36,067,012100,3,b25002
360670162002,"Block Group 2, Census Tract 162, Onondaga County, New York",668,618,50,36,067,016200,2,b25002
360670045001,"Block Group 1, Census Tract 45, Onondaga County, New York",327,272,55,36,067,004500,1,b25002
360670045002,"Block Group 2, Census Tract 45, Onondaga County, New York",630,609,21,36,067,004500,2,b25002
360670110221,"Block Group 1, Census Tract 110.22, Onondaga County, New York",766,766,0,36,067,011022,1,b25002
360670123002,"Block Group 2, Census Tract 123, Onondaga County, New York",657,591,66,36,067,012300,2,b25002
360670129001,"Block Group 1, Census Tract 129, Onondaga County, New York",665,577,88,36,067,012900,1,b25002
360670129002,"Block Group 2, Census Tract 129, Onondaga County, New York",474,386,88,36,067,012900,2,b25002
360670140001,"Block Group 1, Census Tract 140, Onondaga County, New York",655,607,48,36,067,014000,1,b25002
360670140002,"Block Group 2, Census Tract 140, Onondaga County, New York",254,222,32,36,067,014000,2,b25002
360670140003,"Block Group 3, Census Tract 140, Onondaga County, New York",672,484,188,36,067,014000,3,b25002
360670016002,"Block Group 2, Census Tract 16, Onondaga County, New York",1144,961,183,36,067,001600,2,b25002
360670016001,"Block Group 1, Census Tract 16, Onondaga County, New York",1039,935,104,36,067,001600,1,b25002
360670035002,"Block Group 2, Census Tract 35, Onondaga County, New York",321,260,61,36,067,003500,2,b25002
360670035003,"Block Group 3, Census Tract 35, Onondaga County, New York",541,426,115,36,067,003500,3,b25002
360670059002,"Block Group 2, Census Tract 59, Onondaga County, New York",318,273,45,36,067,005900,2,b25002
360670101002,"Block Group 2, Census Tract 101, Onondaga County, New York",794,634,160,36,067,010100,2,b25002
360670104001,"Block Group 1, Census Tract 104, Onondaga County, New York",713,677,36,36,067,010400,1,b25002
360670110111,"Block Group 1, Census Tract 110.11, Onondaga County, New York",328,313,15,36,067,011011,1,b25002
